.,.,.,.,.,.,.,.,.,.,.,.,.,.,.,.,.,.,.,.,5,.,.,.,.,.,.,.,.,.,.,.,.,.,.,.,.,.,.,.,.,.,4,.,.,.,.,.,.,.
.,.,.,.,X,X,X,X,X,X,.,.,.,.,.,.,X,X,X,X,X,X,X,X,.,.,.,.,X,X,X,X,X,X,.,.,X,.,.,.,X,X,X,X,X,X,X,X,X,X
.,.,.,.,.,.,.,.,.,.,.,.,.,.,.,.,.,.,.,.,.,.,.,.,.,.,.,.,.,.,.,.,.,.,.,.,X,.,.,.,.,.,.,.,.,.,.,.,X,X
.,.,.,.,.,.,.,.,.,.,.,.,.,.,1,.,.,.,.,.,.,.,.,.,.,.,.,.,.,.,.,.,.,.,.,.,X,.,.,.,.,.,.,.,.,.,.,E,X,X
X,X,X,X,X,X,X,X,X,X,.,.,X,X,X,X,X,X,X,X,X,X,X,X,X,.,X,X,X,X,X,X,X,X,X,X,.,.,X,X,X,X,X,X,X,X,X,X,X,X
.,.,.,.,.,.,.,.,.,.,.,.,.,.,.,.,.,.,.,.,.,.,.,.,X,.,.,.,.,.,.,.,.,.,.,.,.,.,.,.,.,.,.,.,.,.,.,.,.,.
.,.,.,.,.,.,.,.,.,.,.,.,.,.,.,.,.,.,.,.,9,.,.,.,X,.,.,.,.,.,.,.,.,.,.,.,.,.,.,.,.,.,.,.,.,.,.,.,.,.
.,.,X,X,X,X,X,X,X,X,X,.,.,.,X,X,X,X,X,X,X,X,X,X,.,.,.,.,X,X,X,X,X,X,X,X,.,.,.,.,X,X,X,X,X,X,X,X,.,.
.,.,.,.,.,.,.,.,.,.,X,.,.,.,.,.,.,.,.,.,.,.,.,.,.,.,.,.,.,.,.,.,.,.,.,.,.,.,.,.,.,.,.,.,.,.,.,.,.,.
.,.,.,.,.,.,2,.,.,.,X,.,.,.,.,.,.,.,.,.,.,.,.,.,.,.,.,.,.,.,.,.,3,.,.,.,.,.,.,.,.,.,8,.,.,.,.,.,.,.
.,.,.,.,X,X,X,X,X,X,.,.,.,.,.,.,X,X,X,X,X,X,X,X,.,.,.,.,X,X,X,X,X,X,.,.,X,.,.,.,X,X,X,X,X,X,X,X,.,.
.,.,.,.,.,.,.,.,.,.,.,.,.,.,.,.,.,.,.,.,.,.,.,.,.,.,.,.,.,.,.,.,.,.,.,.,X,.,.,.,.,.,.,.,.,.,.,.,.,.
.,.,.,.,.,.,.,.,.,.,.,.,.,.,1,.,.,.,.,.,.,.,7,.,.,.,.,.,.,.,.,.,.,.,.,.,X,.,.,.,.,.,.,.,.,.,.,.,.,.
X,X,X,X,X,X,X,X,X,X,.,.,X,X,X,X,X,X,X,X,X,X,X,X,X,.,X,X,X,X,X,X,X,X,X,X,.,.,X,X,X,X,X,X,X,X,X,X,X,X
.,.,.,.,.,.,.,.,.,.,.,.,.,.,.,.,.,.,.,.,.,.,.,.,X,.,.,.,.,.,.,.,.,.,.,.,.,.,.,.,.,.,.,.,.,.,.,.,.,.
.,.,.,.,.,.,.,.,.,.,.,.,.,.,.,.,.,.,.,.,4,.,.,.,X,.,.,.,.,.,.,.,.,.,.,.,.,.,.,.,.,.,.,.,6,.,.,.,.,.
.,.,X,X,X,X,X,X,X,X,X,.,.,.,X,X,X,X,X,X,X,X,X,X,.,.,.,.,X,X,X,X,X,X,X,X,.,.,.,.,X,X,X,X,X,X,X,X,.,.
.,.,.,.,.,.,.,.,.,.,X,.,.,.,.,.,.,.,.,.,.,.,.,.,.,.,.,.,.,.,.,.,.,.,.,.,.,.,.,.,.,.,.,.,.,.,.,.,.,.
.,.,.,.,.,.,2,.,.,.,X,.,.,.,.,.,.,.,.,.,.,.,.,.,.,.,.,.,.,.,.,.,3,.,.,.,.,.,.,.,.,.,.,.,.,.,.,.,.,.
.,.,.,.,X,X,X,X,X,X,.,.,.,.,.,.,X,X,X,X,X,X,X,X,.,.,.,.,X,X,X,X,X,X,.,.,.,.,X,X,X,X,X,X,X,X,.,.,.,.
.,.,.,.,.,.,.,.,.,.,.,.,.,.,.,.,.,.,.,.,.,.,.,.,.,.,.,.,.,.,.,.,X,.,.,.,.,.,.,.,.,.,.,.,.,.,.,.,.,.
.,.,.,.,.,.,.,.,.,.,.,.,.,.,.,.,.,.,.,.,3,.,.,.,.,.,.,.,.,.,.,.,X,.,.,.,.,.,5,.,.,.,.,.,.,.,.,.,.,.
.,.,.,.,.,.,X,X,X,X,.,.,.,.,X,X,X,X,X,X,.,.,X,.,.,.,X,X,X,X,.,.,.,.,.,.,X,X,X,X,X,X,.,.,.,.,.,.,.,.
.,.,.,.,.,.,.,.,.,.,.,.,.,.,.,.,.,.,.,.,.,.,X,.,.,.,.,.,.,.,.,.,.,.,.,.,.,.,.,.,.,.,.,.,.,.,.,.,.,.
.,.,.,.,.,.,.,.,.,.,.,.,1,.,.,.,.,.,2,.,.,.,X,.,.,.,.,.,.,.,1,.,.,.,.,.,.,.,.,.,.,.,.,.,.,.,.,.,.,.
X,X,X,X,X,X,X,X,X,.,X,X,X,X,X,X,X,X,X,X,X,X,.,.,X,X,X,X,X,X,X,X,.,.,X,X,X,X,X,X,X,X,X,X,X,X,X,X,X,X
.,.,.,.,.,.,.,.,X,.,.,.,.,.,.,.,.,.,.,.,.,.,.,.,.,.,.,.,.,.,.,.,.,.,.,.,.,.,.,.,.,.,.,.,.,.,.,.,.,.
.,.,S,.,.,.,.,H,X,.,.,.,.,.,.,.,.,.,.,.,.,.,.,.,.,.,.,.,.,.,.,.,.,.,.,.,.,.,.,.,.,.,.,.,.,.,.,.,.,.
X,X,X,X,X,X,X,X,X,X,X,X,X,X,X,X,X,X,X,X,X,X,X,X,X,X,X,X,X,X,X,X,X,X,X,X,X,X,X,X,X,X,X,X,X,X,X,X,X,X
X,X,X,X,X,X,X,X,X,X,X,X,X,X,X,X,X,X,X,X,X,X,X,X,X,X,X,X,X,X,X,X,X,X,X,X,X,X,X,X,X,X,X,X,X,X,X,X,X,X
